常用系统工作命令
echo -->在终端输出字符串或变量提取后的值
date -->显示和设置系统的时间和日期
reboot -->重启系统
poweroff -->关闭系统
wget -->在终端下载网络文件
ps -->查看系统中进程状态
top -->动态监视进程活动和系统负载等信息
pidof-->查询某个指定进程的pid值
kill -->用于终止某个pid进程

系统状态检测命令
ifconfig -->网卡配置和网络状态等信息
uname -->系统内核和版本的信息
uptime -->系统负载信息
free -->系统的内存使用量信息
who -->当前登录主机的用户终端信息
last -->系统所以的登录信息
history -->显示系统执行过的命令
sosreport -->收集系统配置输出和框架信息并输出诊断文档

工作目录切换命令
pwd -->显示用户当前的工作目录
cd --> 切换工作路径
ls -->显示目录中的文件信息

文本文件编辑命令
cat -->用于查询纯文本文件（内容较少的）
more --> 用于查询纯文本文件（内容较多的）
head -->查看纯文本文件的前N行
tail -->查看后N行和持续更新的内容
tr --> 替换文本文件中的字符
wc --> 统计指定文本的行数，字数，字节数
stat -->文本的具体储存信息和时间信息等
cut --> 按列提取文本字符
diff -->比较多个文本文件的差异

文件目录管理命令
touch -->创建空白文件和设置文件时间
mkdir -->创建空白目录
cp --> 复制文件和目录
mv -->剪切文件或将文件重命名
rm -->删除文件或者目录
dd -->指定大小和个数的数据块来复制或转换文件
file --> 查看文件类型

打包压缩和搜索命令
tar -->对文件进行打包压缩和解压
grep -->在文本中执行关键词搜索，并显示结果
find--> 指定条件查找文件

